
                                        Value in Art – Understanding Value as an Element of Art
                                    


                                        Color in Art – Exploring One of the Most Important Elements of Art
                                    


                                        Art Heists – Looking at the Most Notorious Art Museum Heists in History
                                    


                            Elements of Art – An Analysis of the Seven Elements of Art
                        


                            Medici Family – Who Were the Medicis, the Famous Art Family?
                        


                            Readymade Art – Take a Look at the Legacy Left by Readymade Artists
                        


                            Famous Philosophers – Explore the Most Important Philosophers in History
                        


                            Aesthetic Movement – The Elevated Tastes of the Victorian Aesthetic Style
                        


                            70s Art – Take a Look at the Vibrant Style of 70s Abstract Art
                        


                            Wood Carving Art – Explore the History of the Interesting Art of Carving
                        


                            Naïve Art – Discover the Style of the Naïve Painting Art Form
                        


                            Notan – Exploring Notan Designs and Notan Art Examples
                        


                            Tenebrism – Understanding the Use of Tenebrism in Art
                        


                            Indian Art – Discover the History and Influence of Ancient Indian Art
                        


                            Lithography – Understanding the Art of Lithography Printmaking
                        


                            Art Nouveau – The Decorative Stylings of the Art Nouveau Movement
                        


                            Neo-Primitivism – Discover Neo-Primitivism Art and Its Main Artists
                        


                            Post-Impressionism – The History of Post-Impressionism Art and Its Artists
                        


                            Types of Illustration – Explore the Ideas and Styles of Illustration That Exist
                        


                            What Paintings Are in the Louvre? – Exploring the Best Louvre Artworks
                        


                            What Is Creativity? – Explore the Creativity Definition and Its Place in Art
                        


                            Difference Between Art and Craft – A Look at Art Versus Craft
                        


                            Artist Statement Examples – A Look at Famous Artist Statements
                        


                            What Is Contemporary Art? – A Look at Modern Contemporary Art of Today
                        


                            Art Quotes – Looking at the Most Inspirational Quotes on Art
                        


                            Gesamtkunstwerk – Explore Gesamtkunstwerk in Architecture and Art
                        


                            Types of Visual Art – Explore the Different Visual Art Forms That Exist
                        


                            Archaic Greek Art – An Overview of the Greek Archaic Period
                        




                            Ikebana Art – Learn About the Japanese Art of Flower Arrangement
                        


                            Sfumato – The History and Use of the Sfumato Technique
                        


                            Bauhaus Art – Explore the Exciting Art and Style of the Bauhaus Movement
                        


                            Hellenistic Art – Exploring the History of Hellenistic Greek Art and Sculpture
                        


                            Cycladic Art – A Look at the Marble Figures and Sculptures of This Era
                        


                            Jomon Pottery – Discover This Style of Ancient Japanese Pottery
                        


                            Iconoclasm – Looking at the History of Icons in Iconoclasm Art
                        


                            Avant-Garde Art – One of the Major Art Movements of the 20th Century
                        


                            Balance in Art – Exploring the Different Types of Balance Artworks
                        


                            Tonalism – Exploring American Tonalism and the Paintings of the Style
                        


                            Harmony in Art – Looking at Different Examples of Harmony in Art
                        


                            Monochromatic Art – A Look at Monochrome Art Throughout History
                        


                            Proportion in Art – What Does Proportion Mean in Art?
                        


                            Diptych Art – A Look at the History and Style of Diptych Artwork
                        


                            Texture in Art – Exploring the Use of Texture in Painting and Art
                        


                            Color Field Painting – Exploring the Style of Color Block Art and Its Artists
                        


                            Paleolithic Art – A Look at Paleolithic Culture and Its History
                        


                            Rhythm in Art – What Exactly Is Rhythm in Art?
                        


                            Greek Pottery – An Overview of the Development of Ancient Greek Pottery
                        


                            Primitive Art – An Exploration of the Origins of Primitivism in Art
                        


                            Unity in Art – Taking a Look at Unity and Variety in Art
                        


                            Ethiopian Art – An Exploration of Ancient Ethiopian Art and Culture
                        


                            Movement in Art – Exploring the Use of Visual Movement in Art
                        


                            Roman Mosaic – An Overview of Ancient Roman Mosaic and Tiles
                        


                            Mexican Muralism Art – An In-Depth Look at the Mexican Mural Movement
                        


                            Emphasis in Art – Exploring the Use of Visual Emphasis in Works of Art
                        


                            Principles of Art – Understanding the Principles of Design in Art
                        


                            Hispanic Art – Looking at Famous Hispanic Painters and Their Artworks
                        


                            Appropriation in Art – An Overview of Artistic Appropriation in the Art World
                        


                            1930s Art – A Look at the Art and Artists of America After the Fall
                        


                            Neo-Impressionism – An Exploration of Neo-Impressionism Art
                        


                            Dystopian Surrealism – The Other-Worldly Horrors of Dystopian Art
                        


                            Contrapposto – What Is Contrapposto, the Famous Classical Pose?
                        


                            Symbolism Art – Learning About the History and Artworks of this Movement
                        


                            South American Art – An Exploration of Latino Art History
                        


                            Orientalism Art – The Politics and Paintings of Orientalism Art History
                        


                            Native American Art – A History and Overview of American Indian Art
                        


                            Art Deco – A Summary of the Art Deco Era
                        


                            Minoan Art – The Most Notable Minoan Artifacts, Paintings, and Art
                        


                            Neoplasticism – An Essential Look at Neoplasticism Art
                        


                            Sumerian Art – The Pottery, Carvings, and Architecture of Sumer Art
                        


                            Arte Povera – What Was the Arte Povera Movement?
                        


                            Formalism Art – Understanding Formalistic Theory in Art
                        


                            Non-Objective Art – Finding a Non-Objective Art Definition
                        


                            Socialist Realism – The History of the Communist Art Movement
                        


                            Mesopotamian Art – Exploring the Architecture and Art of Mesopotamia
                        


                            Feminist Art – An Empowering Look at Feminism in Art
                        


                            Retrofuturism – Taking a Look Back at Retrofuturistic Art
                        


                            Neolithic Art – An Exploration of Neolithic Period Art
                        


                            Tessellation Art – A Guide to the Art of Tessellation Patterns
                        


                            Figurative Art – A Look at the World of Figurative Abstract Art
                        


                            Chinese Art – An Introductory Chinese Art History Guide
                        


                            Korean Art – Exploring Both Traditional and Modern Korean Art
                        


                            Prehistoric Art – An Exploration of the Prehistoric Art History Timeline
                        


                            Types of Art – A Brief Exploration of the Different Kinds of Art
                        


                            Sublime Art – The History of the Sublime Art Movement
                        


                            Renaissance Facts – A Brief Overview of Renaissance History
                        


                            Lowbrow Pop Surrealism – A Look at the Popular Lowbrow Art Movement
                        


                            Neo-Expressionism – An Exploration of Contemporary Expressionism Art
                        


                            Islamic Art – An Exploration of Islamic Art and Architecture
                        


                            African Art – Looking at African Artwork from Early Humankind to Today
                        


                            De Stijl Art – Exploring the Geometric Art of the De Stijl Movement
                        


                            Memento Mori Art – The Philosophy of the Inevitable Nature of Death in Art
                        


                            Illusion Art – Delving into the Deceptive World of Optical Illusion Art
                        


                            Christian Art – A History of Christian Artwork and Biblical Paintings
                        


                            Celtic Art – An Exploration of the Ancient Celts’ Art History and Styles
                        


                            Best Art History Books – A Curated List of the Best Books About Art History
                        


                            Japanese Art – Looking at the Most Famous Japanese Artists and Artworks
                        


                            Harlem Renaissance Art – A Timeline of Art in the Harlem Renaissance
                        


                            Why Is Art Important? – A Holistic Investigation into the Importance of Art
                        


                            Egyptian Art – An Exploration of Ancient Egyptian Art and Its Influences
                        


                            Suprematism – The Art and Artists of the Russian Suprematism Movement
                        


                            Romanesque Art – The Art and Architecture of the Romanesque Period
                        


                            Representational Art – The Development of Representational Artworks
                        
                                        Famous Street Photographers – Looking at the Best Urban Photographers
                                    


                                        Auguste Rodin – Who Is Auguste Rodin and Why Is He Famous?
                                    


                                        Katarzyna Kobro – Explore the Life of This Avant-Garde Polish Sculptor
                                    


                            Marcel Duchamp – Explore Marcel Duchamp’s Art and Interesting Life
                        


                            Jean-Léon Gérôme – Discover Jean-Léon Gérôme’s Paintings and Impact
                        


                            Diego Rivera – Discover the Life and Legacy of Diego Rivera’s Art
                        


                            Tom of Finland Art – A Look at the Influence of Touko Laaksonen on Art
                        


                            Paul Signac – A Look at the Biography and Works of Paul Signac the Artist
                        


                            Alice Neel – A Look at the Life and Works of Alice Neel the Artist
                        


                            Louis Wain – Discover the Life and Artistic Legacy of Louis William Wain
                        


                            Henri Rousseau – A Look at the Life of the Tropical Paintings Artist
                        


                            Alberto Giacometti – The Legacy of Artist Alberto Giacometti’s Sculptures
                        


                            Max Beckmann – Taking a Look at Max Beckmann’s Artworks and Legacy
                        


                            Famous Portrait Photographers – The Top Photo Portrait Artists of All Time
                        


                            Richard Billingham – Taking a Look at Richard Billingham’s Photography
                        


                            Camille Pissarro – Looking at the Life and Works of Pissarro the Artist
                        


                            H. R. Giger Art – An In-Depth Exploration of Gigeresque Art
                        


                            Andrew Wyeth – An Introduction to the Artist Andrew Wyeth and His Works
                        


                            Giorgio de Chirico – One of the Top Famous Italian Painters
                        


                            James Abbott McNeill Whistler – A Biographic Study of Whistler’s Paintings
                        


                            John Singer Sargent – The Life and Art of Painter John Singer Sargent
                        


                            Frans Hals – Discover the Life and Artworks of This Dutch Painter
                        


                            Georges Braque – Explore the Cubism Artworks by This French Artist
                        


                            Donatello – A Look at Renaissance Artist Donato di Niccolò di Betto Bardi
                        


                            Giorgio Morandi – The Life and Art of Italian Painter Giorgio Morandi
                        


                            Raffaello Sanzio da Urbino – Who Was Raphael and Why Is He Famous?
                        


                            Alfred Stieglitz – The Art and Works of Photographer Alfred Stieglitz
                        


                            Famous Portrait Artists – The Greatest Portrait Painting Artists of All Time
                        


                            Édouard Vuillard – A Look at Édouard Vuillard’s Paintings and Biography
                        


                            James Ensor – Explore the Life and Art of the Expressionism Painter
                        


                            Famous Dutch Painters and Paintings – Art of the Dutch Golden Age
                        


                            Famous Photographers – The Most Famous Photographers of All Time
                        


                            Claude Cahun – A Look at Claude Cahun’s Life and Artistic Contribution
                        


                            Cindy Sherman – An In-Depth Look at Cindy Sherman’s Art and Life
                        


                            Jock Sturges – The Controversial Life of the Nude Photographer
                        


                            Famous Female Photographers – The Pioneers of Female Photography
                        


                            Winslow Homer – The Life and Paintings of the Famous Watercolor Artist
                        


                            Mary Cassatt – The Life and Works of This Female Impressionism Artist
                        


                            Jenny Saville – Exploring Jenny Saville’s Paintings and Contribution to Art
                        


                            Caravaggio – Exploring the Life of One of the Top Italian Baroque Painters
                        


                            William Turner – The Life and Romantic Works of J. M. W. Turner
                        


                            Walker Evans – Uncovering the Life and Art of Photographer Walker Evans
                        


                            Robert Mapplethorpe – Discover Robert Mapplethorpe’s Art and Brief Life
                        


                            Camille Claudel – A Look at Camille Claudel’s Sculptures and Tragic Life
                        


                            Salvador Dalí – A Look at the Surrealism Art and Life of This Spanish Artist
                        


                            Louise Bourgeois – Exploring the Life and Art of Sculptor Louise Bourgeois
                        


                            Damien Hirst – A Closer Look at the Celebrated Artist That Is Damien Hirst
                        


                            Eva Hesse – The Brief Life and Incredible Works of Eva Hesse the Artist
                        


                            Henry Moore – Discovering the Life of English Sculptor Henry Moore
                        


                            Andy Warhol – A Look at the Life and Pop Art Paintings of Andy Warhol
                        


                            Takashi Murakami – Discover the Life and Work of This Japanese Artist
                        


                            Masaccio – Exploring the Life and Works of This Notable Florentine Painter
                        


                            David Hockney – Exploring the Pop Art Works of Painter David Hockney
                        


                            Bisa Butler – An In-Depth and Informative Bisa Butler Biography
                        


                            Sofonisba Anguissola – The Legendary Female Renaissance Painter
                        


                            Ansel Adams – A Look at the Life of Photographer Ansel Adams
                        


                            Henri de Toulouse-Lautrec – A Look at the Iconic Art Nouveau Illustrator
                        


                            Otto Dix – Looking at the Creator of the Extraordinary Otto Dix Paintings
                        


                            Takato Yamamoto – Exploring the Erotic World of Takato Yamamoto’s Art
                        


                            Jean Michel Basquiat – Uncovering the Man Behind Basquiat’s Paintings
                        


                            Georgia O’Keeffe – A Georgia O’Keeffe Portrait, the Mother of Modern Art
                        


                            Fra Angelico – A Look at This Iconic Early Renaissance Painter
                        


                            Robert Delaunay – A Look at the Artist Behind Robert Delaunay’s Paintings
                        


                            Anselm Kiefer – Exploring the Life and Art of This German Artist
                        


                            Maxfield Parrish – A Glimpse at the Life Behind Maxfield Parrish’s Prints
                        


                            Jackson Pollock – A Look at the Famous Creator of the Drip Painting
                        


                            Famous Collage Artists – A Look at Notable Artists and Their Collage Art
                        


                            Katsushika Hokusai – The Life and Works of This Famous Japanese Artist
                        


                            Henri Matisse – An Exploration of the Life and Art of Henri Matisse
                        


                            Ernst Ludwig Kirchner – A Look at the German Expressionism Artist
                        


                            Gustave Courbet – An Artistic Biography of This French Realist Painter
                        


                            Jasper Johns – A Look at the Life of the Abstract Expressionist Painter
                        


                            Kazimir Malevich – A Glimpse at the Artist Behind Kazimir Malevich’s Art
                        


                            Lucian Freud – Taking a Look at Lucian Freud’s Art and Biography
                        


                            Roy Lichtenstein – Taking a Look at the Life and Art of Roy Lichtenstein
                        


                            Frida Kahlo – An Exploration of the Life of Frida Kahlo and Her Artworks
                        


                            Jacopo Tintoretto – A Look at the Life Behind Tintoretto’s Artworks
                        


                            Hannah Höch – The Life and Works of Collage Artist Hannah Höch
                        


                            Norman Rockwell – An Overview of Normal Rockwell’s Illustrations and Life
                        


                            Albrecht Dürer – The Paintings and Etchings of This Famous German Artist
                        


                            Mark Rothko – An Overview of Rothko’s Abstract Expressionism Period
                        


                            Edvard Munch – A Look at the Artist Behind Edvard Munch’s Paintings
                        


                            Pablo Picasso – The Life and Works of This Famous Cubism Artist
                        


                            Eugène Delacroix – An Overview of French Painter Delacroix
                        


                            Caspar David Friedrich – An In-Depth Look at This Romanticism Artist
                        


                            Sandro Botticelli – The Life and Works of This Famous Florence Artist
                        


                            Famous Art Nouveau Artists – Looking at the Creators of Art Nouveau Art
                        


                            Vincent van Gogh – The Art and Life of Painter Vincent Willem van Gogh
                        


                            Max Ernst – An Artistic Biography and Portrait of Max Ernst
                        


                            Egon Schiele – The Life and Artworks of Austrian Painter Schiele
                        


                            François Boucher – Exploring the Fantasies of Boucher’s Artwork
                        


                            Piet Mondrian – The Life and Works of the Famous Color Block Artist
                        


                            Keith Haring – An Introduction to Keith Haring’s Biography and Art
                        


                            Marc Chagall – Looking at the Life and Art Style of Modern Painter Chagall
                        


                            Gerhard Richter – An Artistic Biography of This Famous German Artist
                        


                            Giotto di Bondone – The Life and Art of Giotto the Renaissance Painter
                        


                            René Magritte – Exploring the Life of This Famous Belgian Surrealist Artist
                        


                            Michal Cole – The Life and Works of Contemporary Artist Michal Cole
                        


                            Zdzisław Beksiński – The Life and Works of the Famous Polish Horror Artist
                        


                            Jack Vettriano – The Life and Art of Scottish Artist Jack Vettriano
                        


                            M. C. Escher – A Biography of Tessellation Artist Maurits Cornelis Escher
                        


                            Joan Miró – Exploring the Life and Art of This Barcelona Surrealist
                        


                            Hieronymus Bosch – The Medieval Art of This Master of Earthly Delights
                        
                                        The Physical Impossibility of Death in the Mind of Someone Living – A Look
                                    


                                        “Campbell’s Soup” by Andy Warhol – Discover This Famous Pop Art Piece
                                    


                                        Claude Monet “Water Lilies” – Impressions of Monet’s Water Lily Art
                                    


                            “The Origin of the World” by Gustave Courbet – Art by Gustave Courbet
                        


                            “The Ambassadors” by Hans Holbein the Younger – A Detailed Analysis
                        


                            “Venus of Willendorf” – A Study of This Famous Fertility Goddess Statue
                        


                            “The Creation of Adam” by Michelangelo – The God Touching Adam Fresco
                        


                            “Gates of Paradise” by Lorenzo Ghiberti – The World-Famous Bronze Door
                        


                            Francisco Goya “Black Paintings” – Examining Goya’s Dark Paintings
                        


                            Find an Artist by Name – How to Find the Artist of a Painting
                        


                            “Bacchus” by Caravaggio – Analyzing the Famous Painting of Dionysus
                        


                            “Rhythm 0” – Looking at Marina Abramović’s 1974 Art Performance
                        


                            Famous Greek Paintings of Gods – The Best Greek Mythology Paintings
                        


                            “Nocturne in Black and Gold” – Whistler’s Famous “Falling Rocket” Painting
                        


                            “Haystacks” by Claude Monet – Monet’s Grainstacks at Giverny Paintings
                        


                            “The Kiss” Sculpture by Auguste Rodin – Analyzing Rodin’s “The Kiss”
                        


                            Sistine Chapel Ceiling Painting by Michelangelo – Sistine Chapel Art
                        


                            Famous Picasso Paintings – Looking at the Best of Picasso’s Art
                        


                            “Fountain” by Marcel Duchamp – Duchamp’s Controversial Urinal Art
                        


                            “Girl With a Pearl Earring” Painting – Johannes Vermeer’s Famous Artwork
                        


                            “The Swing” by Jean-Honoré Fragonard – The “L’Escarpolette” Painting
                        


                            “Starry Night Over the Rhône” – Looking at Van Gogh’s Star-Filled Painting
                        


                            Famous Chinese Paintings – Works by the Most Famous Chinese Artists
                        


                            “The Flower Carrier” by Diego Rivera – Analyzing “El Cargador de Flores”
                        


                            “Arnolfini Portrait” by Jan van Eyck – The Arnolfini Wedding Painting
                        


                            “Manneken Pis” Statue – Discover the Famous Peeing Statue in Brussels
                        


                            Michelangelo Sculptures – Explore the Famous Michelangelo Works
                        


                            “Wanderer Above the Sea of Fog” by Caspar David Friedrich – An Analysis
                        


                            Nefertiti Bust – Discover the Iconic Egyptian Bust of Nefertiti
                        


                            “Augustus of Prima Porta” – A Look at the Famous Caesar Augustus Statue
                        


                            “The Thinker” Statue by Auguste Rodin –  Discover the Thinking Man Statue
                        


                            “La Primavera” by Sandro Botticelli – A “Primavera” Painting Analysis
                        


                            “Nude Descending a Staircase” – Discover Duchamp’s Nudity Painting
                        


                            Famous French Revolution Paintings – The Art of the French Revolution
                        


                            “Guernica” by Picasso – Analyzing This Famous Spanish Civil War Painting
                        


                            “Woman With a Hat” by Henri Matisse – A Look at Henri Matisse’s Painting
                        


                            Famous Renaissance Sculptures – The Top Sculptures of the Renaissance
                        


                            “Black Iris” Painting by Georgia O’Keeffe – A Study of O’Keeffe’s Iris Art
                        


                            Donatello “David” – Looking at Donatello’s Two “David” Sculptures
                        


                            Bernini “David” – A Study on the David Statue by Gian Lorenzo Bernini
                        


                            “The Cursed Woman” Painting by Tassaert – A “La Femme Damnée” Study
                        


                            Types of Sculpture – Explore the Different Forms of Sculpture That Exist
                        


                            “Fallen Angel” by Alexandre Cabanel – The Famous Painting of Lucifer
                        


                            Albrecht Dürer “Adam and Eve” – Dürer’s Famous Renaissance Painting
                        


                            “Tree of Life” by Gustav Klimt – Looking at the Famous Stoclet Frieze
                        


                            “Liberty Leading the People” by Eugène Delacroix – A Detailed Analysis
                        


                            Statue of Unity – Learn Everything About the World’s Tallest Statue
                        


                            Zeus Statue Olympia – Discover Greek Art and the Iconic Statue of Zeus
                        


                            Mérode Altarpiece – A Look at the Mérode Triptych by Robert Campin
                        


                            “The Great Masturbator” by Salvador Dalí – A Surrealism Analysis
                        


                            Discobolus Statue – A Look at the Disc Thrower Statue From Greek Art
                        


                            “Moses” Michelangelo – Discover the “Moses” Statue by Michelangelo
                        


                            “The Soul of the Rose” by John William Waterhouse – A Detailed Analysis
                        


                            “Venus de Milo” Sculpture – Discover the Famous Statue Without Arms
                        


                            “The Veiled Virgin” Statue – The Famous Marble Statue With a Veil
                        


                            “Christ the Redeemer” Statue – An Analysis of the Giant Jesus Statue
                        


                            Marie Antoinette Family Portrait by Élisabeth Vigée le Brun – An Analysis
                        


                            “Christ of the Abyss” Statue – A Look at Guido Galletti’s Famous Work
                        


                            Ghent Altarpiece by Jan van Eyck – Studying Jan van Eyck’s Iconic Work
                        


                            Maman Sculpture – Looking at the Giant Spider Art by Louise Bourgeois
                        


                            “The Old Guitarist” Picasso – Analyzing Picasso’s Guitar Painting
                        


                            “The Two Fridas” by Frida Kahlo – Studying Frida Kahlo’s Famous Painting
                        


                            Kazimir Malevich “Black Square” – Analyzing the Famous Square Painting
                        


                            Abstract Sculptures – Looking at Famous Sculpture Artists and Their Work
                        


                            “Song of the Lark” Painting by Jules Breton – A Detailed Analysis
                        


                            Famous Black and White Paintings – A List of the Best Black and White Art
                        


                            Paris Street; Rainy Day – Gustave Caillebotte’s Rainy Day Painting
                        


                            “The Dance” Matisse – Analyzing Matisse’s Dancing Circle Painting
                        


                            “Les Demoiselles d’Avignon” Picasso – A Pablo Picasso Artwork Analysis
                        


                            The Rape of Proserpina – An In-Depth Study of the Famous Bernini Statue
                        


                            Famous Romanticism Paintings – The Best Examples of Romantic-Era Art
                        


                            Titian “Venus of Urbino” – Analyzing the Famous “Venus of Urbino” Painting
                        


                            Famous Autumn Paintings – Looking at the Best Paintings of Fall
                        


                            “The Bedroom in Arles” Van Gogh – A Study of His Iconic Bedroom Artwork
                        


                            Famous Paintings – Taking a Look at the World’s Most Popular Paintings
                        


                            “Composition with Red, Blue and Yellow” Piet Mondrian – On Abstract Art
                        


                            “The Third of May 1808” Francisco Goya – Analyzing Goya’s “Third of May”
                        


                            “The Potato Eaters” Van Gogh –  Analyzing “The Potato Eaters” Painting
                        


                            Famous Renaissance Portraits – Best Renaissance-Style Portrait Paintings
                        


                            Vincent van Gogh Sunflowers – Admiring Van Gogh’s Flower Paintings
                        


                            Yves Klein Blue Painting – Analyzing This Blue Monochromatic Painting
                        


                            Van Gogh Skeleton Smoking – An Enlightening Look at the Van Gogh Skull
                        


                            “Impression, Sunrise” Claude Monet – Analyzing Monet’s Sunrise Painting
                        


                            “The Ecstasy of Saint Teresa” by Gian Lorenzo Bernini – An Analysis
                        


                            “The Son of Man” Magritte – An Analysis of the Famous Apple Painting
                        


                            “The Raft of the Medusa” Théodore Géricault – A Romanticism Analysis
                        


                            Aphrodite of Knidos Statue – Analyzing This Classical Female Sculpture
                        


                            Rembrandt Self-Portrait – The Best Self-Portrait Paintings by Rembrandt
                        


                            Van Gogh Self-Portrait – Some of Van Gogh’s Most Famous Self-Portraits
                        


                            Famous Basquiat Paintings – Looking at the Best of Basquiat’s Art
                        


                            “The Stone Breakers” Gustave Courbet – A History and Analysis
                        


                            “The Great Wave Off Kanagawa” Katsushika Hokusai – An Analysis
                        


                            “View of Toledo” El Greco – Analyzing the “Vistas de Toledo” Painting
                        


                            Le Déjeuner sur l’herbe – Looking at Manet’s “Luncheon on the Grass”
                        


                            What Is a Triptych? – Looking at the Best Triptych Examples
                        


                            “Café Terrace at Night” Van Gogh – A “Terrace at Night” Painting Analysis
                        


                            “Woman with a Parasol” Claude Monet – A Detailed Analysis
                        


                            “The Nightmare” Henry Fuseli – Inspecting “The Nightmare” Painting
                        


                            “The Scream” Edvard Munch – Analyzing the Famous Scream Painting
                        


                            Hall of Bulls Lascaux – An Exploration of the Lascaux Cave Paintings
                        


                            The Banjo Lesson Painting Henry Ossawa Tanner – A Detailed Analysis
                        


                            A Sunday Afternoon on the Island of La Grande Jatte – An Analysis
                        


                            Four Horsemen of the Apocalypse Dürer – An Analysis
                        
                                        The Physical Impossibility of Death in the Mind of Someone Living – A Look
                                    


                                        “Venus of Willendorf” – A Study of This Famous Fertility Goddess Statue
                                    


                                        “Gates of Paradise” by Lorenzo Ghiberti – The World-Famous Bronze Door
                                    


                            “The Kiss” Sculpture by Auguste Rodin – Analyzing Rodin’s “The Kiss”
                        


                            “Fountain” by Marcel Duchamp – Duchamp’s Controversial Urinal Art
                        


                            “Manneken Pis” Statue – Discover the Famous Peeing Statue in Brussels
                        


                            Michelangelo Sculptures – Explore the Famous Michelangelo Works
                        


                            Nefertiti Bust – Discover the Iconic Egyptian Bust of Nefertiti
                        


                            “Augustus of Prima Porta” – A Look at the Famous Caesar Augustus Statue
                        


                            “The Thinker” Statue by Auguste Rodin –  Discover the Thinking Man Statue
                        


                            Famous Renaissance Sculptures – The Top Sculptures of the Renaissance
                        


                            Donatello “David” – Looking at Donatello’s Two “David” Sculptures
                        


                            Bernini “David” – A Study on the David Statue by Gian Lorenzo Bernini
                        


                            Types of Sculpture – Explore the Different Forms of Sculpture That Exist
                        


                            Statue of Unity – Learn Everything About the World’s Tallest Statue
                        


                            Zeus Statue Olympia – Discover Greek Art and the Iconic Statue of Zeus
                        


                            Discobolus Statue – A Look at the Disc Thrower Statue From Greek Art
                        


                            “Moses” Michelangelo – Discover the “Moses” Statue by Michelangelo
                        


                            “Venus de Milo” Sculpture – Discover the Famous Statue Without Arms
                        


                            “The Veiled Virgin” Statue – The Famous Marble Statue With a Veil
                        


                            “Christ the Redeemer” Statue – An Analysis of the Giant Jesus Statue
                        


                            “Christ of the Abyss” Statue – A Look at Guido Galletti’s Famous Work
                        


                            Maman Sculpture – Looking at the Giant Spider Art by Louise Bourgeois
                        


                            Abstract Sculptures – Looking at Famous Sculpture Artists and Their Work
                        


                            The Rape of Proserpina – An In-Depth Study of the Famous Bernini Statue
                        


                            “The Ecstasy of Saint Teresa” by Gian Lorenzo Bernini – An Analysis
                        


                            Aphrodite of Knidos Statue – Analyzing This Classical Female Sculpture
                        


                            Nike of Samothrace – A Look at the “Winged Victory of Samothrace” Statue
                        


                            Spear Bearer Doryphoros – An Analysis of This Famous Greek Sculpture
                        


                            Famous Sculptures – A Look at History’s Most Famous Sculptures
                        


                            Jeff Koons’ Balloon Dog – A Look at the Iconic “Balloon Dog” Sculpture
                        


                            Medusa With the Head of Perseus – A Fresh Take on the Perseus Statue
                        


                            Bernini Sculptures – A Look at the Best Gian Lorenzo Bernini Statues
                        


                            Famous Neoclassical Sculptures – Top 18th-Century Neoclassical Statues
                        


                            Famous Greek Statues – An Exploration of Ancient Greek Sculpture
                        


                            Michelangelo Pietà – Analysing Michelangelo’s Vatican Pietà Statue
                        
                                        Art Challenges – Exploring Different Drawing Challenge Ideas
                                    


                                        What Is Inktober? – Exciting Ideas for the Trending October Art Challenge
                                    


                                        Notan – Exploring Notan Designs and Notan Art Examples
                                    


                            Pottery Painting Ideas – A Guide to Painting Pottery for Beginners
                        


                            Types of Easels – Exploring the Best Kinds of Art Easels for Painting
                        


                            Wet-on-Wet Watercolor – Tips for Wet-on-Wet Painting Techniques
                        


                            Best Masking Fluid – What Is Masking Fluid and How to Use It?
                        


                            How to Paint on Fabric – Your Guide to Creating Hand-Painted Clothes
                        


                            How to Thin Acrylic Paint – The Best Methods for Thinning Acrylic Paint
                        


                            How to Paint Rocks – Tutorial and Easy Rock Painting Ideas for Beginners
                        


                            Acrylic Paint on Glass – A Guide to Painting Glass With Acrylic Paint
                        


                            How to Mix Watercolors – All You Need to Know About Watercolor Mixing
                        


                            Watercolor Techniques – A Comprehensive Guide to Watercolor Basics
                        


                            Acrylic Pour Painting – Your Guide to the Best Paint Pouring Techniques
                        


                            Easy Oil Painting Ideas – Simple Oil Painting Ideas for Beginners
                        


                            Watercolor Painting Ideas – Easy Watercolor Techniques for Beginners
                        


                            Watercolor Skin Tones – How to Make Skin Color With Watercolor
                        


                            How to Paint Water – Your Guide to Painting Water With Watercolor Paints
                        


                            How to Paint a Sunset With Watercolors – Fun Watercolor Sunset Painting
                        


                            How to Use Watercolor Pencils – Your Guide to Watercolor Pencil Art
                        


                            Abstract Watercolor – Easy Watercolor Abstract Painting Techniques
                        


                            How to Paint a Watercolor Beach – Creating a Fun Beach Scenery Painting
                        


                            How to Find Your Art Style – Exploring Some Exciting Art Styles to Try
                        


                            How to Paint Watercolor Trees – An Easy Guide to Watercolor Trees
                        


                            How to Paint Clouds With Watercolor – An Easy Watercolor Sky Tutorial
                        


                            How to Paint a Watercolor Galaxy – An Easy Watercolor Galaxy Tutorial
                        


                            How to Paint Watercolor Sunflowers – Easy Sunflower Painting Tutorial
                        


                            How to Clean an Oil Painting – The Best Oil Painting Cleaners
                        


                            Watercolor Poppies – How to Paint Poppies in Watercolor
                        


                            How to Paint a Watercolor Butterfly – A Watercolor Butterfly Tutorial
                        


                            Watercolor Mountains – How to Paint Mountains for Beginners
                        


                            How to Paint Watercolor Leaves – A Detailed Guide to Watercolor Greenery
                        


                            How to Paint Watercolor Roses – Easy Rose Watercolor Painting Tutorial
                        


                            Watercolor Landscape – A Beautiful Watercolor Scenery Painting Tutorial
                        


                            Enamel vs. Acrylic – The Difference Between Acrylic and Enamel Paint
                        


                            Acrylic Painting Ideas – Exciting Painting Ideas for Beginners
                        


                            Gouache vs. Acrylic – The Difference Between Gouache and Acrylic Paints
                        


                            How to Thicken Acrylic Paint – A Guide to Using Acrylic Paint Thickener
                        


                            How to Use Gouache Paint – An In-Depth Guide to Gouache Techniques
                        


                            Can You Use Watercolor on Canvas? – A Guide to Watercolor Canvas Art
                        


                            Is Acrylic Paint Safe for Skin? – How to Remove Acrylic Paint from Skin
                        


                            Spray Paint Art – Exploring Exciting Spray Paint Art Techniques
                        


                            What Is Bristol Paper? – Your Guide to the Different Types of Bristol Paper
                        


                            Acrylic Paint on Wood – Your Guide to Acrylic Paint on Woodwork
                        


                            Acrylic Paint on Plastic – The Best Guide to Acrylic Painting on Plastic
                        


                            How to Stretch Watercolor Paper – A Guide to Stretching Watercolor Paper
                        


                            Painting Ceramics with Acrylic Paint – A Guide to Painting Ceramics
                        


                            Best Watercolor Brushes – Your Guide to the Top Watercolor Brush Sets
                        


                            Acrylic Paint on Leather – The Best Acrylic Leather Paint for All Your Needs
                        


                            What Is Tempera Paint? – Making and Using Powdered Tempera Paint
                        


                            How to Paint Wine Glasses – Your Guide to Personal Wine Glass Painting
                        


                            Best Acrylic Paintbrushes – Exploring the Types of Paint Brushes for Acrylic
                        


                            Best Gouache Paint – A Guide to Finding the Best Gouache Paint Set
                        


                            How Long Does It Take Gesso to Dry? – How to Apply Gesso and Dry It
                        


                            What Is a Watercolor Block? – Looking at the Best Paper for Watercolor
                        


                            What Are Standard Canvas Sizes? – Exploring Typical Canvas Sizes
                        


                            Watercolor Painting Tips – How to Paint With Watercolor for Beginners
                        


                            How to Make Oil Paint Dry Faster – A Guide to Oil Paint Drying Times
                        


                            What Is Acrylic Paint? – Acrylic Paint Uses, Ingredients, and More
                        


                            Watercolor vs. Acrylic – The Difference Between Watercolor and Acrylic
                        


                            What Colors Make Blue? – How to Make Blue Paint
                        


                            Oil Painting Mediums – Choosing the Best Medium for Oil Painting
                        


                            Best Oil Paints – A Guide to Oil Painting for Beginners
                        


                            Acrylic Paint on Paper – The Best Paper for Acrylic Paints
                        


                            What Colors Make Red – A Guide to Creating Different Shades of Red
                        


                            How to Draw a Rose – A Guide to Creating Your Own Rose Drawings
                        


                            How to Clean Oil Paint Brushes – Cleaning Oil Paint Brushes Effectively
                        


                            How to Clean Acrylic Paint Brushes – A Guide on Acrylic Paint Cleaning Up
                        


                            Foreshortening – A Guide on Foreshortened Drawings and Paintings
                        


                            Best Watercolor Pencils – Learning How to Use Watercolor Pencils
                        


                            Acrylic Paint on Fabric Tutorial – Tips, Tricks & Step-by-Step Instructions
                        


                            Best Acrylic Paint – Complete Guide for Finding your Matching Acrylics
                        


                            How Long Does Oil Paint Take to Dry? – A Guide on Drying Oil Paint
                        


                            Oil Painting Techniques – A Beginner’s Introduction to Oil Painting Styles
                        


                            Oil vs. Acrylic – Looking at the Difference Between Acrylic and Oil Paint
                        


                            Oil Painting for Beginners – A Novice’s Guide on How to Use Oil Paints
                        


                            How to Use Oil Pastels – A Guide on the Best Oil Pastel Techniques
                        


                            Best Watercolor Paints – Choosing the Best Watercolor Set for Your Art
                        


                            Is Acrylic Paint Toxic? – A Guide on the Key Acrylic Paint Ingredients
                        


                            Acrylic Painting for Beginners – How to Paint with Acrylics
                        
                                        Shades of White – How to Create and Use Different Shades of White
                                    


                                        Color in Art – Exploring One of the Most Important Elements of Art
                                    


                                        Shades of Yellow – Exploring Different Yellow Colors in Art and Design
                                    


                            Split Complementary Colors – What Is a Complementary Color Scheme?
                        


                            Indigo Color – What Color Is Indigo and How Can You Use It in Your Art?
                        


                            Neutral Colors – How to Create and Use a Neutral Color Palette
                        


                            Khaki Color – A Deep Dive Into Making and Using Shades of Khaki
                        


                            Shades of Orange – A Deep Dive Into the Different Types of Orange Color
                        


                            Complementary Colors – How to Use Complementary Colors in Art
                        


                            What Colors Go With Pink? – The Best Colors That Complement Pink
                        


                            Lilac Color – Exploring Lilac Purple and the Colors That Go With It
                        


                            Zorn Palette – How to Create and Use Your Own Zorn Palette Colors
                        


                            Burgundy Color – How to Make and Use Different Shades of Burgundy Red
                        


                            Color Emotions – Exploring Colors Associated With Emotions
                        


                            What Colors Go With Maroon? – Colors that Complement Maroon Décor
                        


                            What Colors Go With Orange? – The Best Accent Colors for Orange
                        


                            Mauve Color – A Deep Dive Into the Mauve Color Palette
                        


                            Ivory Color – Exploring Different Shades of Ivory and Cream Colors
                        


                            Pastel Colors – How to Make and Use Your Own Pastel Color Palette
                        


                            Lavender Color – Understanding All the Different Shades of Lavender
                        


                            Shades of Gray Color – Constructing and Using a Gray Color Palette
                        


                            Taupe Color – A Deep Dive Into the Wonderful Shades of Taupe
                        


                            Triadic Colors – A Guide to Understanding the Triadic Color Wheel
                        


                            Pewter Color – Exploring Shades of Pewter and Color Combinations
                        


                            Periwinkle Color – Looking at Different and Unique Shades of Periwinkle
                        


                            Shades of Red – Exploring and Using the Red Color Spectrum
                        


                            Shades of Teal – How to Build Your Own Unique Teal Color Palette
                        


                            How to Make Teal – A Guide to Mixing the Different Shades of Teal
                        


                            Color Wheel – Our free Online Color Wheel App and In-Depth Guide
                        


                            Tertiary Colors – Discovering the Possibilities of Intermediate Colors
                        


                            Muted Colors – Your Guide to Making and Using a Muted Color Palette
                        


                            Shades of Purple – A Comprehensive Look at the Different Types of Purple
                        


                            Warm Colors – What Is the Difference Between Cool and Warm Colors?
                        


                            What Colors Make Gold? – A Detailed Guide on How to Mix Gold Paint
                        


                            Shades of Brown – Exploring the Shades of the Brown Color Palette
                        


                            Color Mixer – The Best Free Online Color Mixing Tool
                        


                            What Colors Make Gray? – A Guide on How to Make Gray
                        


                            What Colors Make Yellow? – How to Make Yellow Paint in Various Shades
                        


                            What Colors Make Black? – A Guide on How to Make Black Paint
                        


                            What Colors Make Orange? – How to Mix Different Shades of Orange
                        


                            What Colors Make Blue? – How to Make Blue Paint
                        


                            What Colors Make Red – A Guide to Creating Different Shades of Red
                        


                            Shades of Blue – A Color-Mixing Guide on How to Make Blue
                        


                            What Colors Make Pink? – How to Mix the Different Shades of Pink
                        


                            What Colors Make Purple? – Creating Different Shades of Purple
                        


                            What Colors Make Green? – Your Guide for Mixing Shades of Green
                        


                            Color Combinations – Exploring the Best Color Combinations for Artists
                        


                            How to Make Brown Paint – A Guide on Mixing Brown Tones
                        


                            Mixing Colors – A Detailed Guide on Mixing Paint Colors
                        


                            How to Make Skin Color – A Guide on Painting Skin Tones
                        
                                        Farnsworth House – The House Built by Ludwig Mies van der Rohe
                                    


                                        Shades of White – How to Create and Use Different Shades of White
                                    


                                        Fallingwater House – Discover Frank Lloyd Wright’s Architectural Style
                                    


                            Indigo Color – What Color Is Indigo and How Can You Use It in Your Art?
                        


                            Neutral Colors – How to Create and Use a Neutral Color Palette
                        


                            Khaki Color – A Deep Dive Into Making and Using Shades of Khaki
                        


                            What Colors Go With Pink? – The Best Colors That Complement Pink
                        


                            Brutalist Architecture – A Look at the Development of Brutalist Design
                        


                            What Colors Go With Orange? – The Best Accent Colors for Orange
                        


                            Spanish Architecture – Exploring the Most Famous Architecture in Spain
                        


                            Art Deco Architecture – The History of 1920s Art Deco Architecture
                        


                            What Colors Go With Brown? – Unique Brown Complementary Colors
                        


                            Famous Buildings – Looking at the World’s Most Iconic Buildings
                        


                            Tallest Buildings in the World – Traversing the World’s Tallest Skyscrapers
                        


                            Maya Lin – A Look at the Life and Works of Architect Maya Lin
                        


                            Bauhaus Architecture – An In-Depth Look at Bauhaus Building Styles
                        


                            Filippo Brunelleschi –  The Renaissance Architecture of Brunelleschi
                        


                            Antoni Gaudí – An Exploration of the Life of This Spanish Architect
                        


                            Rococo Architecture – Exploring the Rococo Era and Its Style
                        


                            Byzantine Architecture – Exploring the Style of Constantinople Architecture
                        


                            Famous Architects – A Guide to Celebrated Architectural Designers
                        


                            Georgian Architecture – The Understated Style of Georgian Buildings
                        


                            Art Nouveau Architecture – The Art and Architects of Art Nouveau Buildings
                        


                            Baroque Architecture – The Decorative Style of 17th-Century Architecture
                        


                            Greek Architecture – An Exploration of Ancient Greek Structures
                        


                            Gothic Architecture – An Overview of Gothic-Style Architecture
                        


                            Roman Architecture – An Inside Look at Ancient Roman Buildings
                        


                            Egyptian Architecture – The Greatest Egyptian Monuments and Buildings
                        


                            Neoclassical Architecture – Buildings Made in the Neoclassical Style
                        


                            Victorian Architecture – The Best Victorian-Era Buildings and Architects
                        


                            Famous Female Architects – A Look at the Notable Women in Architecture
                        


                            Classical Architecture – Exploring the Buildings of the Classical Period
                        


                            Renaissance Architecture – A Look at Architecture During the Renaissance
                        